border_size=1
usage=map

Re Ds Re Ds Re Ds Re Ds
Ds Re Ds Re Ds Re Ds Re
Re Ds Re Ds Re Ds Re Ds
Ds Re Ds Re Ds Re Ds Re
Re Ds Re Ds Re Ds Re Ds
Ds Re Ds Re Ds Re Ds Re
Re Ds Re Ds Re Ds Re Ds
Ds Re Ds Re Ds Re Ds Re